# Interaktif
#TODO: Tinjau dan Standarisasi

[ Not holding items ]=[Tidak memegang barang]
[Cannot pull valve]=[Tidak dapat menarik katup]
[Hands full]=[Tangan penuh]
[Nothing to store]=[Tidak ada yang disimpan]
[Pulling cord]=[Menarik tali]
[Wait for ship to land]=[Tunggu kapal mendarat]

# A-M
Access terminal : [E]=Akses terminal: [E]

Beam up : [E]=Teleportasi: [E]

Charge item : [E]=Mengisi daya barang: [E]
Climb : [E]=Mendaki: [E]
Close door : [E]=Menutup pintu: [E]
Confirm: [B]   |   Rotate: [R]   |   Store: [X]=Konfirmasi: [B]  |   Putar: [R]  |   Simpan: [X]

Disable speaker: [E]=Nonaktifkan speaker: [E]

Enter : [E]=Masuk: [E]
Enter: [E]=Masuk: [E]
Exit : [E]=Keluar: [E]
Exit: [E]=Keluar: [E]

Fire : [LMB]=Menembak: [LMB]
Flip switch: [E]=Membalikkan sakelar: [E]
Flush: [E]=Bilas: [E]

Get log : [E]=Mendapatkan log: [E]
Grab : [E]=Mengambil: [E]
Grab: [E]=Mengambil: [E]

Hit pumpkin : [E]=Menyerang labu: [E]

Inspect: [Z]=Memeriksa: [Z]

Land ship : [E]=Mendaratkan kapal: [E]
Let go : [E]=Melepaskan: [E]
Lift glass : [E]=Mengangkat kaca: [E]

# N-Z
Open : [E]=Membuka: [E]
Open door : [E]=Membuka pintu: [E]
Open hatch : [E]=Membuka lubang: [E]
Open: [E]=Membuka: [E]
Open gift : [LMB]=Membuka kado: [LMB]

Place on door : [LMB]=Meletakkan di pintu: [LMB]
Play record: [E]=Memutar rekaman: [E]
Pop up ladder : [LMB]=Munculkan tangga: [LMB]
Power button : [Q]=Tombol daya: [Q]
Pull pin : [LMB]=Menarik pin: [LMB]
Pull switch : [E]=Menarik sakelar: [E]

Quit terminal : [TAB]=Keluar dari terminal: [TAB]

Reload : [E]=Mengisi ulang: [E]
Ring bell: [E]=Berderingkan bel: [E]

Scan : [RMB]=Memindai: [RMB]
Sell item : [E]=Menjual barang: [E]
Send voice : [LMB]=Mengirim suara: [LMB]
Set candles: [E]=Menyusun lilin: [LMB]
Shake can : [Q]=Mengguncang kaleng: [Q]
Sprint: [Shift]=Berlari cepat: [Shift]
Spray : [LMB]=Menyemprotkan: [LMB]
Squeeze : [E]=Memeras: [E]
Start game : [E]=Memulai permainan: [E]
Start ship : [E]=Menyalakan kapal: [E]
Store item : [E]=Menyimpan barang: [E]
Swing shovel : [LMB]=Mengayunkan sekop: [LMB]
Swing sign : [LMB]=Mengayunkan tanda: [LMB]
Switch camera : [E]=Mengganti kamera: [E]
Switch lights : [E]=Mengganti lampu: [E]

Take TZP : [LMB]=Mengambil TZP: [LMB]
Toggle light : [LMB]=Mengalihkan lampu: [LMB]
Toggle laser : [LMB]=Mengalihkan laser: [LMB]
Toggle music : [LMB]=Mengalihkan musik: [LMB]
Turn on booster : [LMB]=Menyalakan penguat: [LMB]
Turn on/off : [E]=Menyalakan/Mematikan: [E]
Turn safety on: [Q]=Menyalakan keamanan: [Q]
Turn safety off: [Q]=Mematikan keamanan: [Q]
Turn page : [Q/E]=Mengganti halaman: [Q/E]

Use airhorn : [LMB]=Menggunakan klakson udara: [LMB]
Use cash register : [LMB]=Menggunakan kasir: [LMB]
Use door : [E]=Menggunakan pintu: [E]
Use grenade : [LMB]=Menggunakan granat: [LMB]
Use hairdryer : [LMB]=Menggunakan pengering rambut: [LMB]
Use DIY-Flashbang : [LMB]=Menggunakan DIY-Flashbang: [LMB]
Use horn : [LMB]=Menggunakan klakson: [LMB]
Use key : [LMB]=Menggunakan kunci: [LMB]
Use key : [LMB]=Menggunakan kunci: [LMB]
Use ladder : [E]=Menggunakan tangga: [E]
Use Large axle : [G]=Menggunakan poros besar: [G]
Use remote : [LMB]=Menggunakan remote: [LMB]

Walk : [W/A/S/D]=Berjalan: [W/A/S/D]

sr:"^(.+) \((.+)\) : (.+)\n$"=$1 ($2):$3